1
########
#  ... #
#  #$# #
#  # # #
#  $ # #
#  #$# #
#   @  #
########
Title: Level 1

2
########
#   #  #
#  **@ #
#.$*   #
###    #
########
Title: Level 2
