1
########
#   #  #
#  **@ #
#.$*   #
###    #
########
Title: Level 1
Author: Blaz Nikolic